#####
#E#.#
#.#.#
#...#
#..S#
#####